NO ./tiles/NO.xpm
SO ./tiles/SO.xpm
WE ./tiles/WE.xpm
EA ./tiles/EA.xpm

F 139,69,19

C 135,206,250

111111111111111111111111111111
100000000000000000000000000001
100000000000000000000000000001
100000000000000000000000000001
110000111110000001111000000001
100000100010000001000100000001
100000100010000001000100000001
100000111110000001111000000001
100000000000000000000000000001
100000000000S00000000000000001
100000000000000000000000000001
100000000000000000000000000001
100000111000011100001110000001
100000001000010001001000000001
100000001000010001001000000001
100000111000011100001110000001
100000000000000000000000011101
100000000000000000000000011001
111111111111111111111111111111
