NO ./tiles/NO.xpm
SO ./tiles/SO.xpm
WE ./tiles/WE.xpm
EA ./tiles/EA.xpm

F 90,45,10
C 220,220,220

1111111111111
1E00000000111
1111000000111
1111100000011
1111110000111
1111111001111
1111111111111
