NO ./tiles/NO.xpm        
SO ./tiles/SO.xpm
WE ./tiles/WE.xpm
EA ./tiles/EA.xpm

F 139,69,19
C 135,206,250






1111111111
1000000001
11111000011111
100000011
1111100011111
10011100111
1001 100001
1001110N01111
1010000000011111111111111111
101000000001
100000000001
100000000001
111111111111
