NO ./tiles/NO.xpm
SO ./tiles/SO.xpm
WE ./tiles/WE.xpm
EA ./tiles/EA.xpm

F 139,69,19
C 135,206,250

111111111111
100000000001
100000000011
10000000011
1000000011
100000011
10000011
1000011
 1110011
    101
    1N1
    111
